5;6
2;0
2;5
1;1;1;1;1;1
0;1;0;1;0;1
1;1;0;1;0;1
1;0;1;1;1;1
1;1;1;0;1;0
